all: saɗa
all: weyiŋ
animal: duruče
arm: ande
ashes: usuguče
back: oŋe
bad: rač
belly: butuːre
big: mitaːga
bird: awade
bite: gas
black: ǯil
blood: tamuke
blow: toro
bone: korgomne
boy: čače
breast: ɲidiče
breast: ɲidige
breathe: uŋu
child: čače
claw: siŋgindiriče
cloud: siɗiče
cold: kirkire
come: ɓouǃ
count: ŋgandi
cut: di
cut: ustu
day: suŋgu
die: ˗irsi
dig: ɓoya
dog: iːse
drink: wur
dry: kamaːs
dust: usuktiče
earth: usuːge
ear: unde
eat: si
egg: walače
eye: oŋoɲǯe
fall: ˗dal
far: tiraŋa
father: me˗
fat (n.): mwide
fear: ɓagaː
feather: abaktiče
few: čaka
fight: ɗisa
finger: ande čače
fingernail: siŋgindiriče
fire: maːse
fish: asiče
five: muduk
float: wada
flow: wie
fly (n.): oŋorče
fly (v.): buk
foot: ere
four: tišet
give: indaǃ
good: ɲaro
grass: ŋariče
green: rahiriŋ
guts: kaǯibike
hair: abake
hand: ande
head: iːse
hear: čiŋa
heart: koŋgose
he/she: če
he/she: če
he/she: ma
he/she: ma
hit: abaːda
hole: ara
horn: yače
I: anaŋga
kill: baga
knee: siminde
know: ursa
lake: morre
laugh: gugo
left: ɲogolo
leg: ere
liver: meče
long: loya
man: yoge
many: weja
meat: iye
moon: erseme
mother: ɓoha
mountain: ŋaɲǯe
mountain: ŋaɲǯe
mouth: uke
name: aŋge
near: mituga
neck: ŋaːse
night: wide
old: erhemme
one: uŋun
person: beke
person: kine
play: waɲ˗
pull: mbai
push: mbaya
rain: korre
rat: nigise
rat: nigise
red: pirro
right: ɲoktodo
river: alale
road: soge
root: mirmiriče
rope: sitte
rotten: pirro
rub: worti
salt: karkade
sand: alale
say: alege
say: ŋada
scratch: goroɲ
seed: bude
see: ora
sew: aːri
sharp: wiyo
short: tuluŋa
sing: laŋičiŋ
sit: uču
skin: miye
sky: korre
sleep: suŋdi
small: ɲǯikega
smoke: lugtiče
smooth: pere
snake: koke
spit: aluke
split: ɗeɗa
squeeze: sika
stand: doya
star: paɗawe
stone: ŋaɲǯe
suck: ɓan
sun: roŋe
sweet: tomoge
swell: ki˗biŋ
swim: wada
tail: ibe
take: ɓaga
they: sa~ha
thick: mitaːge
thin: waːra
thou: iniŋga
thou: iwe
thou: uwe
three: kodos
throw: mbira
tie: aski
tongue: ɲirbe
tooth: ɲirte
tree: ette
turn: kogoloŋ
two: bidak
vomit: bik
walk: abalas
walk: wie
warm: kibeya
wash: daidi
water: uŋge
we (excl.): koska
we (excl.): koska
we (incl.): kona
we (incl.): kona
wet: sume
what: ǯa
when: tukur
where: tir
white: paparaga
who: mina
wind: mege
wipe: wotidi
woman: wure
wood: dugula
year: oso
yellow: pira
