belly: meuŋug
big: guɟugu
blood: guŋulu
blow: bu
bone: guːɟin
child: di-yalik
emu: gumurinɟi
eye: ma-biɟibiɟib
eye: miyaŋargin
fire: nuyug
flower: yulaŋ
fly (n.): diriɟburu
grass: nu-waṇḍa
head: niːmburu
he/she: gaɟu
he/she: -iyina
he/she: ŋayiwu
he/she: nuwu
hit: -ma-ŋ-
hunt: laḷabaŋ
I: -gina
I: ŋayug
kangaroo: diyaŋara
kill: -ma-ŋ-
laugh: wambaɟa
man: diyiːmbul
moon: dabaraŋaɹ̣a
mouth: niyara
navel: naɟururu
rope: munuŋku
sister: babiɲ
smoke: niulan̪
spit: ŋuɟul
sun: ɲailän
they: -adgina
they: dagamulu
they two: -adgina
they two: dagayiram
thou: -adgina
thou: -gina
thou: naminɟu
thou: wurumulu
tongue: niaŋanɟilin
water: gogo
we (excl.): -adgina
we (excl.): yirimulu
we (incl.): -adgina
we (incl.): yuru mulu
we two (excl.): -adgina
we two (excl.): yiŋiram
we two (incl.): -adgina
we two (incl.): bidiyiram
woman: ɲäŋaːruŋ
you two: -adgina
you two: wuŋiram
